000000000000000
000001100000000
000000000000000
000000011100000
000000000000000
000000000000000
000000001111111
000000000000000
000000001000000
000000000000000
000001000000000
000000000000000
000000000000000
000000011100000
000000000000000
000000000000000
000000000000000
000000000000000
000000000000000
000000000000000