000000000000000
000000000000000
000000000000000
000000000000000
000000000000000
000000000000000
111000000000000
000000000000000
000000000000000
000000000000000
000000000000000
111000000000000
000000000000000
000000000011111
000000000010000
000000000010000
000000000010000
000000000010000
000000000001000
000000000001000